Qui seme le vent  recolte du ble d inde pis des petates
La nuit porte  -  porte de garage 
Jouer au ping pong tout seul  -  c est bon pour le cardio  mais c est plate rare 
Il est parti comme  -  une vache dans un jeu de quilles 
Toute verite n est pas  -  toujours vraie 
On ne fait pas d omelettes  -  sans se casser les yeux 
Comme disait le grand Jules Cesar  Oh boy qu on a passe proche 
Rien ne sert de courir  -  car l autobus est deja passe 
Qui vivra  -  ne mourra pas tout de suite 
L avenir appartient a ceux qui se lave tot  car  -  il reste encore de l eau chaude 
Il ne faut pas vendre la peau de l ours  -  surtout s il n est pas d accord avec le prix 
Rome ne s est pas construit en  -  criant lapin  je ne boirai pas de ton eau 
Apres la pluie  -  le gazon est mouille 
Quand j aime une fois  -  j aime une fois et c est ca qui est ca 
Comme disait le grand Sergei  -   C est qui le twit qui a parke son char dans mon stationnement
Je vous le dis  -  les tondeuses sont vertes cette annee 
Comme disait le grand Jules Cesar  -   C est le fun quand il y a pas de bebittes 
Rien se sert de courir  -  il faut partir a go  encaisser deux cent piasses et acheter l avenue Connecticut 
La mort est comme une voleuse qui fuit avec nos ames  mais  -  comme elle a oublie ses cles de char  elle est obligee de faire du pouce 
Apres la douche  -  les cheveux sont secs  -  quand on les a essuyes 
La vengeance est douce  -  quand on la savonne comme il le faut 
J avoue que ca depasse le domaine de l etonnant  va au dela des limites du  -    - kosse ca -  et va atteindre les limites du  - ah ben tabaslak   
 - En se fouillant dans le nez -  Comme disait le grand Jules Cesar  Maudit que la pêche  -  a crottes est bonne cette annee 
Les temperatures nocturnes sur cette planete sont  -  nocturnes 
La fin justifie les moyens  -  loin des yeux loin du coeur  -  demain est un autre jour  -  petit train va loin  -  quatre a deux Canadien 
watatow  -  Tu es chanceuse de nous avoir 
Le temps ne fait rien a l affaire  -  quand on est con on est con
Pourquoi un chasseur emmene t - il son fusil au toilette  -  -  -  Pour tirer la chasse 
Comment appelle - t - on un nain en prison  -  -  -  Un incarcere
Un francais et un chinois sont au bar le francais dit  -  tchin - tchin  -  et le chinois lui répond  -  france - france  - 